30 30
□ □ □ □ □ □ □ □ □ □ □ □ □ □ □ □ □ □ □ □ □ □ □ □ □ □ □ □ □ □
□ □ □ □ □ □ □ □ □ □ □ □ □ □ □ □ □ □ □ □ □ □ □ □ □ □ □ □ □ □
□ □ □ □ □ □ □ □ □ □ □ □ □ □ □ □ □ □ □ □ □ □ □ □ □ □ □ □ □ □
□ □ ✽ □ □ □ □ □ □ □ □ □ □ □ □ □ □ □ □ □ □ □ □ □ □ □ □ □ □ □
□ ⬊ ▼ ▼ ▼ ▼ ▼ ▼ ▼ ▼ ▼ ▼ ▼ ⬋ □ □ □ ○ □ □ □ □ □ □ □ □ □ □ □ □
□ ▶ ➲ ─ ─ ─ ─ ─ ─ ─ ─ ─ ┐ ◀ □ □ □ □ □ □ □ □ □ □ □ □ □ □ □ □
□ ⬈ ▲ ▲ ▲ ▲ ▲ ▲ ▲ ▲ ▲ ⬀ │ ◀ □ □ □ □ □ □ □ □ □ □ □ □ □ □ □ □
□ □ □ □ □ □ □ □ □ □ □ ▶ │ ◀ □ □ □ □ □ □ □ □ □ □ □ □ □ □ □ □
□ □ □ □ □ □ □ □ □ □ □ ▶ │ ◀ □ □ □ □ □ □ □ □ □ □ □ □ □ □ □ □
□ ⬊ ▼ ▼ ▼ ▼ ⬋ □ □ □ □ ▶ │ ⬃ ▼ ▼ ▼ ▼ ▼ ▼ ▼ ⬋ □ □ □ □ □ □ □ □
□ ▶ ┌ ─ ─ ┐ ◀ □ □ □ □ ▶ └ ─ ─ ─ ─ ─ ─ ─ ┐ ◀ □ □ □ □ □ □ □ □
□ ▶ │ ⬁ ⬀ │ ◀ □ □ □ □ ⬈ ▲ ▲ ▲ ▲ ▲ ▲ ▲ ⬀ │ ◀ □ ✽ □ □ □ □ □ □
□ ▶ │ ◀ ▶ │ ◀ □ □ □ □ □ □ □ □ □ □ □ □ ▶ │ ◀ □ □ □ □ □ □ □ □
□ ▶ │ ◀ ▶ │ ◀ □ □ □ □ □ □ □ □ □ □ ✛ □ ▶ │ ◀ □ □ □ □ □ □ □ □
□ ▶ │ ◀ ▶ │ ◀ □ ⧝ □ □ □ □ □ □ □ □ □ □ ▶ │ ◀ □ □ □ □ □ □ □ □
□ ▶ │ ◀ ▶ │ ◀ □ □ ✽ □ □ □ □ □ □ □ □ □ ▶ │ ◀ □ □ □ □ □ □ □ □
□ ▶ │ ◀ ▶ │ ⬃ ▼ ▼ ▼ ▼ ▼ ▼ ▼ ▼ ▼ ▼ ▼ ▼ ⬂ │ ◀ □ □ □ □ □ □ □ □
□ ▶ │ ◀ ▶ └ ─ ─ ─ ─ ─ ─ ─ ─ ─ ─ ─ ─ ─ ─ ┘ ◀ □ □ □ □ □ □ □ □
□ ▶ │ ◀ ⬈ ▲ ▲ ▲ ▲ ▲ ▲ ▲ ▲ ▲ ▲ ▲ ▲ ▲ ▲ ▲ ▲ ⬉ □ □ □ □ ◠ □ □ □
□ ▶ │ ◀ ◠ □ □ □ □ □ □ □ □ □ □ □ □ □ □ □ □ □ □ □ □ □ ◡ ○ □ □
□ ▶ │ ◀ ◡ □ □ □ □ □ ◿ ▽ ◺ □ □ □ □ □ □ □ □ □ □ □ □ □ □ □ □ □
□ ▶ │ ◀ □ □ □ □ □ □ ▷ ■ ◁ ✤ □ □ □ □ □ □ □ □ □ □ □ □ □ □ □ □
□ ▶ │ ◀ □ □ □ □ □ □ ◹ △ ◸ ✣ □ □ □ □ □ □ □ □ □ □ □ □ □ □ □ □
□ ▶ │ ◀ □ □ □ □ □ □ □ □ □ □ □ □ □ □ □ □ □ □ □ □ ⧝ □ □ □ □ □
□ ▶ │ ⬃ ▼ ▼ ▼ ▼ ▼ ▼ ⬋ □ □ □ □ □ □ □ □ □ □ □ □ □ □ □ □ □ □ □
□ ▶ └ ─ ─ ─ ─ ─ ─ ⛔ ◀ □ □ □ □ □ □ □ □ □ □ □ ◿ ▽ ▽ ▽ ◺ □ □ □
□ ⬈ ▲ ▲ ▲ ▲ ▲ ▲ ▲ ▲ ⬉ ✛ □ □ □ □ □ □ □ □ □ □ ▷ ■ ■ ■ ◁ □ □ □
□ □ □ □ □ □ □ □ □ □ □ □ □ □ □ □ □ ✤ □ □ □ □ ▷ ■ ■ ■ ◁ □ □ □
□ □ ⧝ □ □ □ □ □ □ □ ○ □ □ □ □ □ □ ✣ □ □ □ □ ◹ △ △ △ ◸ □ □ □
✽ □ □ □ □ □ □ □ □ □ □ □ □ □ □ □ □ □ □ □ □ □ □ □ □ □ □ □ □ □ □
